%%%%%
%.G.%
%.% %
%.. %
%.P %
%%%%%