WWWWWWWWWWWWWWWWWWW
W--_----_---------W
W--___-----W--_---W
W-F_-------W------W
W-PFF__-W--W_-----W
W-_F-F--W--W--G---W
W--------W_----_--W
WWWWWWWWWWWWWWWWWWW