WWWWWWWWWWWWWWWWWWW
W--G----G---------W
W--_G_-----G--G---W
W-F_--------------W
W-PFF__-----G-----W
W-_F-F------------W
W---------G----G--W
WWWWWWWWWWWWWWWWWWW