%%%%%
%.G.%
%.% %
%.% %
%.P.%
%%%%%