%%%%%%%
% G . %
%.%%..%
% P .%%
%%%%%%%