%%%%%%%%%%%%%%%%%%%%
%o....o%G G %o....o%
%..%...%%  %%...%..%
%.%o.%........%.o%.%
%.o%.%.%%%%%%.%.%o.%
%........P.........%
%%%%%%%%%%%%%%%%%%%%