%%%%%%
% G .%
%.%% %
% % .%
% P  %
%%%%%%